+-------------------+                                                                      
|...................|                  +-----------+                                       
|...................|                  |...........|                +---------+            
|...................|                  |...........|                |.........|            
+----------------#--+                  |...........|                |.........|            
                 #                     +-----#-----+                +----#----+            
         +-------#------+                    #                           #                 
         |..............#############        #                           #                 
         |..............|           ######################################                 
         |..............|                                  #            #                  
         |..............|                      +-----------#------------#-+                
         |..............|                      |..........................|                
         +--------------+                      |..........................|                
                                               |..........................|                
                                               |..........................|                
                                               +--------------------------+                
